GREAT!!! LET'S GO TO LEVEL
17 x 13
|||||||||||||||||
44444444$44444444
4               4
44444444444444  4
4S      (       4
4444444 . 4444444
4F    4 . 4G    4
4  g  4 . 4  g  4
4  f    .    f  4
4     4 . 4     4
4444444 . 4444444
4*      (  bbbbb4
44444444444444444