CARI JALAN KELUAR DAN HINDARI MUSUH!!!:-)
17 x 13
|||||||||||||||||
11111111111111111
1Q   2g     2E a1
1    2      2   X
1   22222       1
1    2b     2   1
1ff         2R  1
122  222222222221
1 W  2baaa      1
1    2b   2222  1
1    22    cb2  1
1 bbbbbbb 2bb2 *1
11111111111111111