GREAT!!! LET'S GO TO LEVEL
17 x 13
|||||||||||||||||
55555555555555555
5*5 (     Z5   .5
5 5J.5     5 5 .5
5 5 ./////)/)/).5
5 5 .55555 5 5 .5
5   (      5 5 .5
5 55.5  5555 5 .5
5 5b.5      L5 .5
5g5b.5 55555 5 .5
555b.5     5 5 .5
5bbb(  5K  5 5 (X
55555555555555555