GREAT!!! LET'S GO TO LEVEL
17 x 13
|||||||||||||||||
66666666666666666
6*  6  6       d6
6bbbbbbb 66666666
6///////)/////]/6
6Nd             6
6/////////////)/6
6666666666666g  6
6              B6
6/)/////////////6
6               6
6  66666 666666C6
66666666@66666666